Graph	  Primi*ves	  
Structure	  of	  the	  Web	
Design	  and	  Analysis	  
of	  Algorithms	  I	  

Tim	  Roughgarden	  
The	  Web	  graph	  
-­‐ Ver*ces	  =	  Web	  pages	  
-­‐ 	  (directed)	  edges	  =	  hyperlinks	  
Ques*on	  :	  what	  does	  the	  web	  graph	  
	  	  	  	  	  	  	  	  look	  like	  ?	  
(assume	  you’ve	  already	  “crawled”	  it)	  
Size	  :	  ~	  200	  million	  nodes,	  ~	  1	  billion	  edges	  
Reference	  :	  [Broder	  et	  al	  WWW	  2000]	  
computed	  the	  SCCs	  of	  the	  Web	  graph.	  
Tim’s	  
papers	  
Tim’s	  
home	  
page	  
A	  co-­‐
author	  
Lists	  of	  online	  
free	  courses	  
Tim’s	  
courses	  
Aquarius	  
Records	  
ETC.	  
ETC.	  
	  
(pre	  map-­‐reduce/hadoop)	  

Tim	  Roughgarden	  
The	  Bow	  Tie	  
e.g.,	  new	  web	  
pages	  
“core	  of	  the	  
web”	  
e.g.,	  corporate	  
websites	  
“tendrils”	  
“tubes”	  

Tim	  Roughgarden	  
1.  All	  4	  parts	  (giant,	  IN,	  OUT,	  tubes	  +	  tendrils	  )	  have	  
roughly	  the	  same	  size	  
2.  Within	  CORE,	  very	  well	  connected	  (has	  the	  “small	  
world”	  property)	  	  [Milgram]	  
3.  Outside,	  surprisingly	  poorly	  connected	  
Main	  Findings	  

Tim	  Roughgarden	  
1.  Temporal	  aspects	  –	  how	  is	  the	  web	  graph	  evolving	  
over	  *me	  ?	  
2.  Informa*onal	  aspects	  –	  how	  does	  new	  informa*on	  
propagate	  throughout	  the	  Web	  (or	  blogosphere,	  or	  
Twieer,	  etc.)	  
3.  Finer-­‐grained	  structure	  –	  how	  to	  deﬁne	  and	  compute	  
“communi*es”	  in	  informa*on	  and	  social	  networks	  ?	  
	  Recommended	  Reading	  :	  Easley	  +	  Kleinberg,	  “Networks,	  
Crowds,	  &	  Markets”	  
Modern	  Web	  Research	  

