	  
ScienceofPeople.com	  
	  
@vvanedwards	  
	  
The	  Nonverbal	  Elevator	  Pitch	  
	  
Adding:	  
___Nonverbal	  Explanation	  
___Palm	  Displays	  
___Visible	  Hands	  
___Launch	  Stance	  
___Torso	  Aiming	  
___Vocal	  Power	  
___Vocal	  Variance	  
	  
Avoiding:	  
___Tucked	  or	  Hidden	  Hands	  
___Over-­‐Expressiveness	  
___Question	  Inflection	  
___High	  Voice	  
___Volume	  Drop	  
___Deer	  in	  the	  Headlights	  
___Memorized	  Cadence	  
___Hopping	  and	  Swaying	  
	  
Verbal:	  
Nonverbal:	  
	  
	  
	  
	  
	  
	  
	  
	  
	  
	  
	  
	  

	  
ScienceofPeople.com	  
	  
@vvanedwards	  
	  
	  
	  
	  
	  
	  
	  
	  
	  
	  
	  
	  
	  
	  
	  
	  
	  
	  
	  
	  

